***************
*             *
**            *
*             *
*             *
*             *
*             *
*             *
*             *
*             *
*             *
*             *
*             *
*             *
***************