******************************
*                            *
*                            *
*                            *
*                            *
*                            *
*                            *
*                            *
*          ***   ***         *
*             ***            *
*                            *
*          S                 *
*                            *
*                            *
*                            *
*                            *
*       ****                 *
*       *  *                 *
*       ****                 *
*                            *
******************************